{
  [ 0, 0, 0, 0, 0, 0, 0, 0, 0, 0, 0 ],
  [ 0, 0, 0, 0, 0, 0, 0, 0, 0, 0, 0 ],
  [ 0, 0, 0, 0, 0, 0, 0, 0, 0, 0, 0 ],
  [ 0, 0, 0, 0, 0, 0, 0, 0, 0, 0, 0 ],
  [ 0, 0, 0, 0, 0, 0, 0, 0, 0, 0, 0 ],
  [ 0, 0, 0, 0, 0, 0, 0, 0, 0, 0, 0 ],
  [ 0, 0, 0, 0, 0, 0, 0, 0, 0, 0, 0 ],
  [ 0, 0, 0, 0, 0, 0, 0, 0, 0, 0, 0 ],
  [ 1, 0, 0, 0, 0, 0, 0, 0, 0, 0, 0 ],
  [ 3, 1, 0, 0, 0, 0, 0, 0, 0, 0, 0 ],
  [ 3, 2, 1, 0, 0, 0, 0, 0, 0, 0, 0 ],
  [ 3, 2, 4, 1, 0, 0, 0, 0, 0, 0, 0 ],
  [ 3, 2, 4, 5, 1, 0, 0, 0, 0, 0, 0 ],
  [ 3, 2, 4, 5, 3, 1, 0, 0, 0, 0, 0 ],
  [ 3, 2, 4, 5, 3, 2, 1, 0, 0, 0, 0 ],
  [ 3, 2, 4, 5, 3, 2, 4, 1, 0, 0, 0 ],
  [ 3, 2, 4, 5, 3, 2, 4, 5, 1, 0, 0 ],
  [ 3, 2, 4, 5, 3, 2, 4, 5, 3, 1, 0 ],
  [ 3, 2, 4, 5, 3, 2, 4, 5, 3, 2, 1 ],
  [ 7, 6, 8, 9, 7, 6, 8, 9, 7, 6, 8 ]
};